%%%%%%%%%%%%%%%%%%%%%%%%%%%%%%%%%
%%.                      P%%%%%%%
%%%     %     %%%%%%%%%%%%%%%%%%%
%%%%   %%%   %%%%%%%%%%%%%%%%%%%%
%%%%%%%%%%%%%%%%%%%%%%%%%%%%%%%%%